VNT = "countries/WestEur.txt" #Venciatia
RME = "countries/WestEur.txt" #Roman Empire
THM = "countries/WestEur.txt" #Thule Maior
ALQ = "countries/WestEur.txt" #Algonconquiana
ANA = "countries/WestEur.txt" #Anasasia
SIN = "countries/Asia.txt" #Sinonian Empire
NIO = "countries/Asia.txt" #Nionian Empire
TRN = "countries/WestEur.txt" #Terra Nova
ABE = "countries/WestEur.txt" #Abenacia
LAC = "countries/WestEur.txt" #Lacota
ARC = "countries/WestEur.txt" #Arcansa
CAL = "countries/WestEur.txt" #Calusa
MXA = "countries/WestEur.txt" #Mexica
MAI = "countries/SouthAm.txt" #Maia
ARA = "countries/SouthAm.txt" #Aravacia
ARU = "countries/SouthAm.txt" #Araucania
HRP = "countries/SouthAm.txt" #Harpeia
GAR = "countries/SouthAm.txt" #Garania
TUP = "countries/SouthAm.txt" #Tupia
ICC = "countries/WestEur.txt" #India Occidentalis
GAE = "countries/Africa.txt" #Gaetulia
NUB = "countries/Africa.txt" #Nubia
ETH = "countries/Africa.txt" #Ethiopia
AFD = "countries/Africa.txt" #African Federation
MAS = "countries/Africa.txt" #Masaesylia
ARB = "countries/MidEast.txt" #Arabia
MAU = "countries/Africa.txt" #Mauritania
LBY = "countries/Africa.txt" #Libya
ALN = "countries/EastEur.txt" #Alania
FEN = "countries/EastEur.txt" #Fennia
PER = "countries/MidEast.txt" #Persia
SAR = "countries/EastEur.txt" #Sarmatia
IND = "countries/Asia.txt" #India
SCY = "countries/EastEur.txt" #Scythia
BAC = "countries/MidEast.txt" #Bactria