VNT = "countries/Venciatia.txt"
RME = "countries/Roman Empire.txt"
THM = "countries/Thule Maior.txt"
ALQ = "countries/Algonconquiana.txt"
ANA = "countries/Anasasia.txt"
SIN = "countries/Sinonian Empire.txt"
NIO = "countries/Nionian Empire.txt"
TRN = "countries/Terra Nova.txt"
ABE = "countries/Abenacia.txt"
LAC = "countries/Lacota.txt"
ARC = "countries/Arcansa.txt"
CAL = "countries/Calusa.txt"
MXA = "countries/Mexica.txt"
MAI = "countries/Maia.txt"
ARA = "countries/Aravacia.txt"
ARU = "countries/Araucania.txt"
HRP = "countries/Harpeia.txt"
GAR = "countries/Garania.txt"
TUP = "countries/Tupia.txt"
ICC = "countries/India Occidentalis.txt"
GAE = "countries/Gaetulia.txt"
NUB = "countries/Nubia.txt"
ETI = "countries/Ethiopia.txt"
AFD = "countries/African Federation.txt"
MAS = "countries/Masaesylia.txt"
ARB = "countries/Arabia.txt"
MAU = "countries/Mauritania.txt"
LBY = "countries/Libya.txt"
ALN = "countries/Alania.txt"
FEN = "countries/Fennia.txt"
PRS = "countries/Persia.txt"
SAR = "countries/Sarmatia.txt"
IND = "countries/India.txt"
SCY = "countries/Scythia.txt"
BAC = "countries/Bactria.txt"
