RTH = "countries/Ruthenia.txt"
BRT = "countries/Britannia.txt"
HIB = "countries/Hibernia.txt"
CLD = "countries/Caledonia.txt"
RHN = "countries/Rhaetia-Norica.txt"
LEC = "countries/Lechia.txt"
ILY = "countries/Illyria.txt"
GOT = "countries/Gothia.txt"
DAN = "countries/Dannia.txt"
HSP = "countries/Hispania.txt"
HBA = "countries/Baetica.txt"
LUS = "countries/Lusitania.txt"
GAU = "countries/Gallia.txt"
GRM = "countries/Germania.txt"
ASI = "countries/Asia-Cappadocia.txt"
MSP = "countries/Mesopotamia.txt"
GRA = "countries/Graecia.txt"
PNN = "countries/Pannonia.txt"
DAC = "countries/Dacia.txt"
MOE = "countries/Moesia.txt"
GTR = "countries/Gallia Transalpina.txt"
LUG = "countries/Gallia Lugdunensis.txt"
BLG = "countries/Belgica.txt"
THR = "countries/Thracia.txt"
BYZ = "countries/Byzantion.txt"
EPY = "countries/Epirus.txt"
BAT = "countries/Batavia.txt"
BOH = "countries/Bohemia.txt"
AFP = "countries/Africa Proconsularis.txt"
AEG = "countries/Aegyptus.txt"
CYR = "countries/Cyrenaica.txt"
GIN = "countries/Germania Inferior.txt"
JTN = "countries/Shin Daichi.txt"
CMB = "countries/Cambria.txt"
IDC = "countries/Indochina.txt"
ING = "countries/Ingria.txt"
TAU = "countries/Taurica.txt"
VND = "countries/Venedia.txt"
FOR = "countries/Formosa.txt"
KUM = "countries/Kumul Khanate.txt"
SIC = "countries/Sichuan.txt"
RYU = "countries/Okinawa.txt"
